1 6 1169 231 1641 784 358 691 
1 10 481 1819 1294 731 2156 361 161 2006 913 358 
1 7 1281 637 1923 156 280 568 1384 
1 10 1281 1391 990 2005 1979 638 1855 1140 1362 2254 
1 7 2196 616 2206 507 1113 518 1391 
1 6 861 866 828 976 854 2196 
1 7 1169 975 2125 1114 353 1337 1715 
1 6 1715 675 554 517 1534 861 
1 14 2117 1390 1408 538 1607 1313 1658 760 1632 1379 1000 1494 1242 1169 
1 8 2111 1693 1827 902 564 89 1320 2117 
1 3 2111 608 1143 
1 6 1143 1696 1216 1554 1984 671 
1 12 2117 1218 2139 2150 1134 487 803 1745 1445 1251 929 1117 
1 2 1117 876 
1 11 876 1096 1398 2215 393 1877 1075 1247 1480 1237 386 
1 2 2254 386 
1 21 546 1488 1947 1961 321 1466 1625 1018 1368 210 1464 17 1414 319 1530 1233 2013 516 2242 15 1237 
1 7 638 1760 306 2257 205 782 584 
1 10 549 413 1911 1073 1400 1878 124 1483 812 584 
1 22 1762 1207 632 455 1225 2247 1779 351 1035 128 1418 40 864 2075 881 1326 1403 379 2280 183 1469 549 
1 6 2075 1189 151 416 1026 52 
1 6 52 919 458 1812 965 1820 
1 7 993 1628 595 308 198 1036 1568 
1 7 993 534 224 2333 1839 60 1486 
1 3 696 1191 2288 
1 22 52 278 982 553 1550 2334 639 1631 609 674 1656 884 1461 1800 425 1122 85 1174 2074 1458 2332 585 
1 16 585 436 1139 1131 187 90 1123 1993 1766 920 852 916 1742 221 817 1451 
1 9 1521 1168 1585 1606 36 1618 1898 1331 1237 
1 17 812 584 1246 1868 1519 1147 2276 1508 1614 1821 2001 1382 1601 411 1946 332 1521 
1 10 1521 512 1549 1061 363 189 2055 249 678 1427 
1 6 1427 1582 750 2031 1172 1451 
1 4 1451 874 821 503 
1 4 1427 2287 1330 1913 
1 6 90 1716 1325 1951 1992 1521 
1 10 1911 1073 2003 899 32 589 619 1505 320 425 
1 4 1488 2238 390 1603 
1 11 540 87 1860 1328 2091 327 252 1164 480 262 503 
1 16 2316 1373 684 1033 383 978 1721 1720 612 1999 1852 1032 1526 1806 1448 540 
1 18 550 1737 1333 33 1259 1955 1042 1206 1417 2109 426 1079 1485 958 258 375 1650 671 
1 17 880 2174 2166 364 5 1592 2151 1089 10 1584 1559 1922 1701 312 404 2102 550 
1 14 71 439 645 1212 1512 604 430 1893 1354 716 424 1514 2174 880 
1 4 1608 1973 879 823 
1 9 823 105 922 1810 1985 1894 1692 704 71 
1 4 1608 48 1232 1282 
1 9 1282 1475 1084 305 1886 447 438 1284 1603 
1 10 1282 1892 2253 1802 1468 1683 310 1105 1980 87 
1 18 390 2231 1353 1781 94 461 292 1091 276 1406 1133 19 1600 543 1179 1083 688 1650 
1 3 2143 1367 1650 
1 4 2143 735 1179 543 
1 3 527 663 1417 
1 11 71 194 336 1841 202 403 445 1289 80 1306 1417 
1 18 880 1771 514 1046 1949 791 502 1848 1129 324 1743 734 2058 1234 391 1652 2310 2316 
1 2 671 1473 
1 3 89 666 847 
1 7 876 110 908 1109 340 1240 1349 
1 11 861 1818 596 813 315 720 1150 980 1856 255 2150 
