1 6 1169 231 1641 784 358 691 
1 10 481 1819 1294 731 2156 361 161 2006 913 358 
1 7 1281 637 1923 156 280 568 1384 
1 10 1281 1391 990 2005 1979 638 1855 1140 1362 2254 
1 7 2196 616 2206 507 1113 518 1391 
1 6 861 866 828 976 854 2196 
1 7 1169 975 2125 1114 353 1337 1715 
1 6 1715 675 554 517 1534 861 
1 14 2117 1390 1408 538 1607 1313 1658 760 1632 1379 1000 1494 1242 1169 
1 8 2111 1693 1827 902 564 89 1320 2117 
1 3 2111 608 1143 
1 6 1143 1696 1216 1554 1984 671 
1 12 2117 1218 2139 2150 1134 487 803 1745 1445 1251 929 1117 
1 2 1117 876 
1 11 876 1096 1398 2215 393 1877 1075 1247 1480 1237 386 
1 2 2254 386 
1 20 386 1421 842 853 1842 36 2262 762 169 661 2255 523 944 1625 1466 321 1961 1947 1488 546 
1 7 638 1760 306 2257 205 782 584 
1 10 549 413 1911 1073 1400 1878 124 1483 812 584 
1 22 1762 1207 632 455 1225 2247 1779 351 1035 128 1418 40 864 2075 881 1326 1403 379 2280 183 1469 549 
1 6 2075 1189 151 416 1026 52 
1 6 52 919 458 1812 965 1820 
1 7 993 1628 595 308 198 1036 1568 
1 7 993 534 224 2333 1839 60 1486 
1 3 696 1191 2288 
1 22 52 278 982 553 1550 2334 639 1631 609 674 1656 884 1461 1800 425 1122 85 1174 2074 1458 2332 585 
1 16 585 436 1139 1131 187 90 1123 1993 1766 920 852 916 1742 221 817 1451 
1 6 1842 36 1606 1585 1168 1521 
1 17 812 584 1246 1868 1519 1147 2276 1508 1614 1821 2001 1382 1601 411 1946 332 1521 
1 10 1521 512 1549 1061 363 189 2055 249 678 1427 
1 6 1427 1582 750 2031 1172 1451 
1 4 1451 874 821 503 
1 4 1427 2287 1330 1913 
1 6 90 1716 1325 1951 1992 1521 
1 10 1911 1073 2003 899 32 589 619 1505 320 425 

